EA ./24.xpm
NO  ./frog.xpm
SO  ./ayman.xpm
WE   ./24.xpm

F 220,100,43
C  20,30,0


111111111
100000001
100000001
100000001
100000001
100000001
100010001
100000001
101000001
100000001
100000101
100N00001
100000001
111111111
