EA ./path_to_the_east_texture
NO  ./path_to_the_north_texture
SO  ./path_to_the_south_texture
WE    ./path_to_the_west_texture

F 220,100,43
C  20,30,0


111111111
100000101
1000000N1
111111111
