EA ./texture/bg.xpm
NO  ./texture/frog.xpm
SO  ./texture/ayman.xpm
WE   ./texture/24.xpm

F 220,100,43
C  20,30,0


 1111111
100000001
100000001
1000000011111111111111111111
10000000100000000000000000001
1000000011111111111111111111111             
100010001
100000001
101000001          1
100000001         1N1
100000101          1
100000001
100000001
 1111111