NO ./sprites/north_wall.xpm
SO ./sprites/south_wall.xpm
WE ./sprites/west_wall.xpm
EA ./sprites/east_wall.xpm

F 100,100,0
C 204,229,255

11111111
100N0101 111
10D01001 101
10000001 111
11111111

11111
10D01
11111
