NO ./sprites/wall_brick0.xpm
SO ./sprites/wall_brick1.xpm
WE ./sprites/wall_brick2.xpm
EA ./sprites/wall_brick3.xpm

C 20,20,20

F 42,42,42

        1111111111111111111111111
        1000000000110000000000001
        1011000001110000000000001
        1001000000000000000000001
111111111011000001110000000000001  1111
100000000011000001110111111111111  100
11110111111111011100000010001      111
11110111111111011101010010001
11000000110101011100000010001
10000000000000000000000000001
10000000000000001101010010001
1100000111010101111101111000111
11110111 1110101 101111010N01
11111111 1111111 111111111111
